
# Core is the library (the server class is a plugin)
core:	; @echo $@

antivirus: content form output	; @echo $@
char_chart: sitemapxml	; @echo $@
content: links	; @echo $@
editor: users output messages permissions sessions	; @echo $@
favicon: path form messages permissions output	; @echo $@
feed: layout path content messages	; @echo $@
filter: content	; @echo $@
form: sessions filter content messages	; @echo $@
header: path layout output	; @echo $@
info: path form messages users output	; @echo $@
javascript: content	; @echo $@
layout: content filter javascript taxonomy	; @echo $@
links: core content	; @echo $@
list: layout filter path output	; @echo $@
mailinglist: core content	; @echo $@
menu: layout content output	; @echo $@
messages: core	; @echo $@
output: layout path javascript messages	; @echo $@
path: content messages	; @echo $@
permissions: layout output users messages	; @echo $@
robotstxt: layout path content	; @echo $@
search: layout content	; @echo $@
sendmail: sessions filter output users	; @echo $@
sessions: layout output	; @echo $@
shorturl: sessions path output messages	; @echo $@
sitemapxml: robotstxt permissions	; @echo $@
taxonomy: layout path output	; @echo $@
users: form sitemapxml output messages sendmail	; @echo $@



# vim: syntax=make ts=64
